Qxu, Qxu, Qxu, Qxu, Qxu, Qxu, Qxu, Qxu, Qxu, Qxu
Qxu, Uu, Ur, Uu, Ur, Uu, Ur, Uu, Ur, Qxu
Qxu, Ur, Uu, Ur, Uu, Ur, Uu, Ur, Uu, Qxu
Qxu, Uu, Ur, Uu, Ur, Uu, Ur, Uu, Ur, Qxu
Qxu, Ur, Uu, Ur, Uu, Ur, Uu, Ur, Uu, Qxu
Qxu, Uu, Ur, Uu, Ur, Uu, Ur, Uu, Ur, Qxu
Qxu, Ur, Uu, Ur, Uu, Ur, Uu, Ur, Uu, Qxu
Qxu, Uu, Ur, Uu, Ur, Uu, Ur, Uu, Ur, Qxu
Qxu, Ur, Uu, Ur, Uu, Ur, Uu, Ur, Uu, Qxu
Qxu, Qxu, Qxu, Qxu, Qxu, Qxu, Qxu, Qxu, Qxu, Qxu